R 1000 1000
NO ./path_to_the_north_texture
SO ./path_to_the_south_texture
WE ./path_to_the_west_texture
EA ./path_to_the_east_texture
S ./path_to_the_sprite_texture
F 220,100,0 // 바닥 rgb
C 225,30,0 // 천장 rgb


1111111111111111111111111
1000000000000000000000001
1000000000000000000000001
100000000000000000000000111111111
100000000000000000000000000000001
100000000000000000000000000011111
11110111111111011100000010001
11110111111111011101010010001
11000000110101011100000010001
10002000000000001100000010001
10000000000000001101010010001
11000001110101011111011110N01
10010111 1110101 100011100001
11111111 1111111 111111111111