R 1200 1200
NO ./src/texture/north.xpm
SO ./src/texture/south.xpm
WE ./src/texture/west.xpm
EA ./src/texture/east.xpm
S ./src/texture/sprite.xpm
F 110,153,15 
C 255,255,0


111111111111
100000000201
101000000201
101010E00201
101000000201
100000000201
111111111111