R 1000 1000
NO src/texture/north.xpm
SO src/texture/south.xpm
WE src/texture/west.xpm
EA src/texture/east.xpm
S src/texture/west.xpm
F 220,100,0						
C 225,30,0						

111111111111111111111
100000000000000000001
1000110000000000W0001
100010000000000000001
100000000000000000001
111111111111111111111