R  6401 4800
NO ./srcs/texture/north.xpm
SO ./srcs/texture/south.xpm
WE ./srcs/texture/west.xpm
EA ./srcs/texture/east.xpm
S ./srcs/texture/sprite.xpm
F 114,153,15
C 255,255,15

1111111111111
1000000002001
1000000002001
1000000002001
1000000002001
1000000002001
1000000002001
1000000002001
1000000002001
1000000002001
1000000002001
1000000002001
1000000002001
1000000002001
1000000002001
1000000002001
100S000002001
1000000002001
1111111111111