R 1200 1200

NO ./src/texture/north.xpm
SO ./src/texture/south.xpm
WE ./src/texture/west.xpm
EA ./src/texture/east.xpm
S ./src/texture/east.xpm
F 110,153,15 
C 255,255,255


111111111111
100000000001
102000000201
102000N00201
102000000201
100000000001
111111111111