R 1000 1000
NO src/texture/north.xpm
SO src/texture/south.xpm
WE src/texture/west.xpm
EA src/texture/east.xpm
S src/texture/west.xpm
F 220,100,0 // 바닥 rgb
C 225,30,0 // 천장 rgb


111111111111111111
100000000000000001
100000000000000001
100000000W00000001
100000000000000001
111111111111111111