R  500 500
NO ./srcs/texture/north.xpm
SO ./srcs/texture/south.xpm
WE ./srcs/texture/west.xpm
EA ./srcs/texture/east.xpm
S ./srcs/texture/barrel.xpm
F 123,153,123
C 1,1, 150

1111111111111
1000000002001
1000000002001
1000000002001
1000000002001
1000000002001
1000000002001
1000000002001
1000000002001
1000000002001
1000000002001
1000000002001
1000000002001
1000000002001
1000000002001
1000000002001
100N000002001
1000000002001
1111111111111