R 1200 1200
NO ./src/texture/north.xpm
SO ./src/texture/south.xpm
WE ./src/texture/west.xpm
EA ./src/texture/east.xpm
S ./src/texture/sprite.xpm
F 110,153,15
C 255,255,15

1111111111111
1000000002001
1010000002001
101010E002011
1010000002001
1000000000011
1111111111111